1,1,1,1,1,1,1,1,1,1,1,1,1,1,1,1,1,1,1,1,1,1,1,1,1,1,1,1,1,1,
1,0,0,0,0,0,0,4,4,4,4,0,0,0,0,0,0,0,0,0,0,0,0,0,0,0,0,0,0,1,
1,0,6,0,4,4,4,4,0,0,3,3,3,3,3,2,3,3,3,2,3,3,3,3,3,3,3,0,0,1,
1,0,0,0,0,0,0,0,0,0,3,0,0,0,0,0,0,6,0,0,0,0,0,0,0,0,3,0,0,1,
1,3,3,0,0,0,0,0,0,0,0,0,6,0,0,0,0,0,0,0,0,0,0,0,0,0,0,0,0,1,
1,3,0,0,0,0,0,0,0,0,0,0,0,0,0,0,0,0,0,2,2,2,2,2,0,0,0,6,0,1,
1,2,0,0,4,0,0,0,0,0,0,0,0,0,0,0,0,0,0,0,0,0,0,0,0,3,0,0,0,1,
1,3,3,0,4,0,3,3,3,3,3,3,2,3,3,3,3,3,3,3,0,0,0,0,0,3,3,0,0,1,
1,0,3,0,4,0,0,0,0,0,0,0,0,1,1,1,1,1,1,3,4,4,4,0,0,0,3,0,0,1,
1,0,3,0,4,0,0,0,0,0,0,0,0,1,1,1,1,1,1,3,4,4,4,0,0,0,3,0,0,1,
1,0,3,3,4,0,0,0,0,0,0,0,0,1,1,1,1,1,1,3,4,4,4,0,0,0,3,0,0,1,
1,0,0,3,4,0,0,0,0,0,0,0,0,1,1,1,1,1,1,3,4,4,4,0,0,0,0,3,0,1,
1,0,0,3,0,0,0,3,0,0,0,0,0,0,0,0,3,3,3,3,4,4,4,0,0,0,0,3,0,1,
1,0,0,0,0,0,0,3,0,0,0,0,0,0,0,0,0,0,0,0,0,0,0,0,0,0,0,3,0,1,
1,0,0,0,0,0,0,3,0,0,0,0,0,0,0,0,0,0,0,0,0,0,0,0,0,0,0,3,0,1,
1,0,0,0,0,0,3,3,0,0,0,0,0,0,0,0,0,0,0,0,0,0,2,2,2,2,0,3,0,1,
1,0,0,0,0,0,3,0,0,0,0,0,3,3,3,3,3,0,0,0,0,2,2,0,0,0,3,3,0,1,
1,0,0,0,0,3,3,0,0,7,0,0,3,0,0,0,3,0,0,0,0,0,0,0,0,0,3,0,0,1,
1,0,3,3,3,3,0,0,0,0,0,0,3,0,5,0,3,0,0,0,0,0,0,0,0,0,0,0,0,1,
1,1,1,1,1,1,1,1,1,1,1,1,1,1,1,1,1,1,1,1,1,1,1,1,1,1,1,1,1,1,